我慢汁	がまん汁
流石	さすが
滅茶苦茶	めちゃくちゃ
イジワル	いじわる
意地悪	いじわる
非モテ	モテない
きもだめし	肝試し

//↓可用于译前统一
オチンチン	おちんちん
チンチン	ちんちん
おちんこ	オチンポ
おちんぽ	オチンポ
おチンポ	オチンポ
雄チンポ	オチンポ
ちんこ	チンポ
ちんぽ	チンポ
おちんぽ	オチンポ


オマンコ	おまんこ
マンコ	まんこ

アヌス	肛門
アナル	肛門

ザーメン	精液