姫	公主	名词
おっぱい	奶子	名词
ちんぽ	肉棒	名词
まんこ	小穴	名词
アイツ	那家伙	代词
アイテム	物品	名词
アタシ	我	代词
アナル	菊花	名词
アニメ	动画	名词
アヌス	菊花	名词
アパート	公寓	名词
アルコール	酒精	名词
アンタ	你	代词
イチモツ	肉棒	名词
イヌ	狗	名词
イベント	事件	名词
イメージ	图像	名词
エッチ	色色	动词
エナジー	能源	名词
エルフ	精灵	名词
エレベーター	电梯	名词
エロ	色情	形容词
オシッコ	尿尿	动词
オチンチン	肉棒	名词
オチンポ	肉棒	名词
オッパイ	奶子	名词
オナニー	自慰	名词
オフィス	办公室	名词
オマエ	你	代词
オマンコ	小穴	名词
オヤジ	老爸	代词
オレ	老子	代词
カップル	情侣	名词
カメラ	相机	名词
カラダ	身体	名词
カリ	咖喱	名词
カレー	咖喱	名词
カード	卡片	名词
ガキ	小鬼	名词
キス	吻	动词
キッチン	厨房	名词
キミ	你	代词
キャラ	角色	名词
クズ	人渣	名词
クラス	班级	名词
クラブ	俱乐部	名词
クリトリス	阴蒂	名词
クリーム	奶油	名词
グラス	玻璃杯	名词
ケダモノ	禽兽	名词
ゲーム	游戏	名词
コイツ	这家伙	代词
コンビニ	便利店	名词
ゴメン	对不起	名词
サイズ	大小	形容词
ザーメン	精液	名词
シャワー	淋浴	动词
シュー	鞋	名词
ショーツ	短裤	名词
ジジイ	爷爷	代词
スイッチ	开关	名词
スカート	裙子	名词
スケベ	好色的	形容词
ステーション	车站	名词
スピード	速度	名词
スマホ	手机	名词
スーツ	西装	名词
ズボン	裤子	名词
セックス	色色	动词
セリフ	台词	名词
センセイ	先生	名词
センパイ	前辈	名词
ソファ	沙发	名词
タイプ	类型	名词
タイミング	时机	名词
タオル	毛巾	名词
ターン	回合	名词
ダイニング	餐厅	名词
ダメージ	伤害	动词
チェック	检查	动词
チャンス	机会	名词
チンコ	肉棒	名词
チンポ	肉棒	名词
テレビ	电视	名词
テンション	紧张	名词
テーブル	桌子	名词
デブ	胖	形容词
データ	数据	名词
デート	约会	名词
トイレ	厕所	名词
ドア	门	名词
ドクター	医生	名词
ドライブ	驾驶	动词
ドラゴン	龙	名词
ドレス	衣服	名词
ナイフ	刀	名词
ナース	护士	名词
ノック	敲门	动词
バイブ	震动器	名词
バナナ	香蕉	名词
バージン	处女	名词
パジャマ	睡衣	名词
パパ	爸爸	名词
パワー	力量	名词
パンツ	内裤	名词
パンティ	内裤	名词
パーク	公园	名词
パーティ	派对	名词
パーティー	派对	名词
パートナー	伙伴	名词
ビール	啤酒	名词
ピストン	活塞	名词
ピンク	粉色	形容词
ファイル	文件	名词
ファン	粉丝	名词
フェラ	口交	名词
フェラチオ	口交	名词
フラワー	花朵	名词
ブタ	猪	名词
ブラ	胸罩	名词
ブラジャー	胸罩	名词
プレイ	玩	动词
ベッド	床	名词
ペニス	肉棒	名词
ページ	页	名词
ホテル	酒店	名词
ホモ	木毛	名词
ホント	真的	名词
ホール	大厅	名词
ボウヤ	少年	名词
ボク	我	代词
ボクッ	我	代词
ボタン	按钮	名词
ポイント	点	名词
ポケット	口袋	名词
ポーズ	姿势	名词
マイク	麦克风	名词
マンコ	小穴	名词
マンション	公寓	名词
ミルク	牛奶	名词
メイド	女仆	名词
メッセージ	消息	名词
メール	邮件	名词
モノ	东西	名词
ヤツ	那家伙	代词
ヨガ	瑜伽	名词
ラブホテル	爱情酒店	名词
ラーメン	拉面	名词
リスク	风险	名词
リビング	客厅	名词
リード	领导	动词
ルーム	房间	名词
レイプ	雷普	动词
レズ	蕾丝	名词
レベル	等级	名词
ロープ	绳子	名词
ワイン	酒	名词
ワシ	我	代词
ワタシ	我	代词
