ass	屁股	noun
asshole	菊花	noun
bitch	婊子	noun
boobs	奶子	noun
breasts	奶子	noun
climax	高潮	noun
cock	肉棒	noun
cum	射精	noun
cunt	小穴	noun
daddy	爸爸	noun
fuck	肏	noun
fuckpet	肉便器	noun
fucktoy	肉便器	noun
fucktoys	肉便器	noun
hole	穴	noun
holes	穴	noun
kitten	小猫咪	noun
lewd	淫荡	noun
master	主人	noun
masturbate	自慰	noun
mommy	妈咪	noun
mouth	嘴	noun
owner	主人	noun
pet	宠物	noun
porn	毛片	noun
pussy	小穴	noun
slave	奴隶	noun
slut	荡妇	noun
toy	玩具	noun
whore	婊子	noun
